0W00000000000000
0R0000000000W000
020000000O000000
000000000W000000
00W000000R000000
0000000000000000
0000000B00W00000
0000000000000000
00Y0000000000000
0000000040000000
0000002000000W00
00000000WW000000
0W0000000000W000
00W0000400000000
0000000000000000
000000000000W000