WWWWRRRRRWWWWWWW
WB0000000000000W
0000000000000W0W
0W0W000000000R0R
0S000000000000SR
00W0000000000W0W
W00000000000WW0W
W00W000000000R0R
W000S000000000SR
W0000000000W0W0W
W000000000000W0W
000000000000WR0R
00000000S00000SR
00000WWW00000W0W
0000000000000WYW
WWW0000000000000