WRWWWWWWWWWWWW00
W000000000000000
W0RWWWWWWWWW0000
W0R0000000000000
W0R0000000000000
0S00000000000000
0S00000000000S00
S000000B00000000
000000WWW0000000
0000000000000000
S000000000000OS0
0S00000000000W00
0S00000000WWWW00
0000000000000000
0Y00000000000000
0W00000000000000