0WB00000000000S0
Y00WWWWWWWWWW0O0
0000000000000000
W000000000000000
0000000000000000
0000000W00000000
000000000W000000
0000000000000000
000000000000000W
00000000W0000000
00W0000000000000
0000000000000000
0000000000000000
W00000000000000W
0000000000000W00
0000000000000000