000SSW000W00WWWW
0000O0W0W000O00W
00W0000R00000W0W
S0000S00000S00OW
SO000S0W0R00S000
W00SSW000WR0000W
0W0000W0W00000W0
00R0W00B00W00R00
0W0000W0W00000W0
W0000W000W00000W
0000000W00000000
000SS000000WW000
0W0OS000000WY0W0
00W0000R00000W00
000W00W0W000W000
00000W000W000000